COMPENSATION	K AA M P AH N S EY SH AH N
ENVELOP	IH N V EH L AH P
FINGER	F IH NG G ER
FOUR	F AO R
FULL	F UH L
GRAB	G R AE B
GRASP	G R AE S P
GRAVITY	G R AE V AH T IY
GRAVITY(2)	G R AE V IH T IY
HALF	HH AE F
HOME	HH OW M
INDEX	IH N D EH K S
MIDDLE	M IH D AH L
OFF	AO F
OKAY	OW K EY
ON	AA N
ON(2)	AO N
PINCH	P IH N CH
READY	R EH D IY
ROBOT	R OW B AA T
ROBOT(2)	R OW B AH T
SET	S EH T
STOP	S T AA P
THREE	TH R IY
TORQUE	T AO R K
ZERO	Z IY R OW
