CLEAR	K L IH R
CONTINUE	K AH N T IH N Y UW
GO	G OW
HOME	HH OW M
LEARN	L ER N
MODEL	M AA D AH L
OKAY	OW K EY
PAUSE	P AO Z
RESUME	R IH Z UW M
RESUME(2)	R IY Z UW M
RESUME(3)	R EH Z AH M EY
ROBOT	R OW B AA T
ROBOT(2)	R OW B AH T
SET	S EH T
START	S T AA R T
STOP	S T AA P
TARGET	T AA R G AH T
TARGET(2)	T ER G AH T
TASK	T AE S K
TEACH	T IY CH
